AngularJS	FRAMEWORK_A
Spring	FRAMEWORK_S
Hibernate	FRAMEWORK_S
Structs	FRAMEWORK_S
java	LANG_S
oracle	LANG_S
netapp	LANG_S
c#	LANG_S
SpaceX	ORGANIZATION
initially	OTHER
tweeted	OTHER
that	OTHER
one	OTHER
of	OTHER
the	OTHER
legs	OTHER
broke	OTHER
after	OTHER
a	OTHER
hard	OTHER
landing	OTHER
,	OTHER
but	OTHER
CEO	OTHER
Elon	PERSON
Musk	PERSON
followed	OTHER
up	OTHER
with	OTHER
a	OTHER
better	OTHER
explanation	OTHER