Abductive logic programming	AI
Abductive reasoning	AI
Abstract data type	AI
Abstraction	AI
Accelerating change	AI
Action language	AI
Action model learning	AI
Action selection	AI
Adaptive algorithm	AI
Adaptive neuro fuzzy inference system	AI
Admissible heuristic	AI
Affective computing	AI
Agent architecture	AI
AI accelerator	AI
AI-complete	AI
Algorithm	AI
Algorithmic efficiency	AI
Algorithmic probability	AI
AlphaGo	AI
Ambient intelligence	AI
Analysis of algorithms	AI
Answer set programming	AI
Anytime algorithm	AI
Application programming interface	AI
Approximate string matching	AI
Approximation error	AI
Argumentation framework	AI
Artificial immune system	AI
Artificial intelligence	AI
Artificial Intelligence Markup Language	AI
Artificial neural network	AI
Association for the Advancement of Artificial Intelligence	AI
Asymptotic computational complexity	AI
Attributional calculus	AI
Augmented reality	AI
Automata theory	AI
Automated planning and scheduling	AI
Automated reasoning	AI
Autonomic computing	AI
Autonomous car	AI
Autonomous robot	AI
Backpropagation	AI
Backward chaining	AI
Batch normalisation	AI
Bayesian programming	AI
Bees algorithm	AI
Behavior informatics	AI
Behavior tree	AI
Belief-desire-intention software model	AI
Bias–variance tradeoff	AI
Big data	AI
Big O notation	AI
Binary tree	AI
Bio-inspired computing	AI
Blackboard system	AI
Boolean satisfiability problem	AI
Brain technology	AI
Branching factor	AI
Brute-force search	AI
Case-based reasoning	AI
Chatterbot	AI
Cloud robotics	AI
Cluster analysis	AI
Cobweb	AI
Cognitive architecture	AI
Cognitive computing	AI
Cognitive science	AI
Combinatorial optimization	AI
Committee machine	AI
Commonsense knowledge	AI
Commonsense reasoning	AI
Computational chemistry	AI
Computational complexity theory	AI
Computational creativity	AI
Computational humor	AI
Computational intelligence	AI
Computational learning theory	AI
Computational linguistics	AI
Computational mathematics	AI
Computational neuroscience	AI
Computational number theory	AI
Computational problem	AI
Computational statistics	AI
Computational vision	AI
Computer-automated design	AI
Computer science	AI
Computer vision	AI
Connectionism	AI
Consistent heuristic	AI
Constraint logic programming	AI
Constraint programming	AI
Constructed language	AI
Control theory	AI
Convolutional neural network	AI
Crossover	AI
Darkforest	AI
Dartmouth workshop	AI
Data fusion	AI
Data integration	AI
Data mining	AI
Data science	AI
Data set	AI
Data warehouse	AI
Datalog	AI
Decision boundary	AI
Decision support system	AI
Decision theory	AI
Declarative programming	AI
Deductive classifier	AI
Deep Blue	AI
Deep learning	AI
Default logic	AI
Description logic	AI
Developmental robotics	AI
Diagnosis	AI
Dialog system	AI
Dimensionality reduction	AI
Discrete system	AI
Distributed artificial intelligence	AI
Dynamic epistemic logic	AI
Embodied agent	AI
Embodied cognitive science	AI
Ensemble averaging	AI
Ethics of artificial intelligence	AI
Evolutionary algorithm	AI
Evolutionary computation	AI
Evolving classification function	AI
Existential risk	AI
Expert systems	AI
Feature extraction	AI
Feature selection	AI
First-order logic	AI
Fluent	AI
Formal language	AI
Forward chaining	AI
Frame	AI
Frame language	AI
Frame problem	AI
Friendly artificial intelligence	AI
Futures studies	AI
Fuzzy control system	AI
Fuzzy logic	AI
Fuzzy set	AI
Game theory	AI
Genetic algorithm	AI
Genetic operator	AI
Glowworm swarm optimization	AI
Google DeepMind	AI
Graph (abstract data type)	AI
Graph (discrete mathematics)	AI
Graph database	AI
Graph theory	AI
Graph traversal	AI
Heuristic	AI
Hidden layer	AI
Hidden unit	AI
Hyper-heuristic	AI
IEEE Computational Intelligence Society	AI
Incremental learning	AI
Inference engine	AI
Information integration	AI
Information Processing Language	AI
Intelligence amplification	AI
Intelligence explosion	AI
Intelligent agent	AI
Intelligent control	AI
Intelligent personal assistant	AI
Interpretation	AI
Issue trees	AI
Kernel method	AI
KL-ONE	AI
Knowledge acquisition	AI
Knowledge-based systems	AI
Knowledge engineering	AI
Knowledge extraction	AI
Knowledge Interchange Format	AI
Knowledge representation and reasoning	AI
Linked data	AI
Lisp	AI
Logic programming	AI
Machine vision	AI
Markov chain	AI
Markov decision process	AI
Mathematical optimization	AI
Machine learning	AI
Machine listening	AI
Machine perception	AI
Mechanism design	AI
Mechatronics	AI
Metabolic network modelling	AI
Metaheuristic	AI
Model checking	AI
Modus ponens	AI
Modus tollens	AI
Monte Carlo tree search	AI
Multi-agent system	AI
Multi-swarm optimization	AI
Mutation	AI
Mycin	AI
Name binding	AI
Named-entity recognition	AI
Named graph	AI
Natural language processing	AI
Natural language programming	AI
Network motif	AI
Neuro-fuzzy	AI
Neurocybernetics	AI
Node	AI
Nondeterministic algorithm	AI
Nouvelle AI	AI
NP	AI
NP-completeness	AI
NP-hardness	AI
Offline learning	AI
Online learning	AI
Ontology engineering	AI
Ontology learning	AI
OpenAI	AI
OpenCog	AI
Open Mind Common Sense	AI
Open-source software	AI
Partial order reduction	AI
Partially observable Markov decision process	AI
Particle swarm optimization	AI
Pathfinding	AI
Pattern recognition	AI
Planner	AI
Predicate logic	AI
Principal Component Analysis	AI
Principle of rationality	AI
Probabilistic programming language	AI
Production Rule Representation	AI
Production system	AI
Programming language	AI
Prolog	AI
Propositional calculus	AI
Python	AI
Qualification problem	AI
Quantifier	AI
Query language	AI
R programming language	AI
Reasoning system	AI
Recurrent neural network	AI
Region connection calculus	AI
Reinforcement learning	AI
Resource Description Framework	AI
Rete algorithm	AI
Robotics	AI
Rule-based system	AI
Satisfiability	AI
Search algorithm	AI
Selection	AI
Self-management	AI
Semantic network	AI
Semantic reasoner	AI
Semantic query	AI
Semantics	AI
Sensor fusion	AI
Separation logic	AI
Similarity learning	AI
Simulated annealing	AI
Situated approach	AI
Situation calculus	AI
SLD resolution	AI
Soft computing	AI
Software	AI
Software engineering	AI
Spatial-temporal reasoning	AI
SPARQL	AI
Speech recognition	AI
Spiking neural network	AI
State	AI
Statistical classification	AI
Statistical relational learning	AI
Stochastic optimization	AI
Stochastic semantic analysis	AI
STRIPS	AI
Subject-matter expert	AI
Superintelligence	AI
Supervised learning	AI
Swarm intelligence	AI
Symbolic artificial intelligence	AI
Synthetic intelligence	AI
Systems neuroscience	AI
Technological singularity	AI
Temporal difference learning	AI
Tensor network theory	AI
TensorFlow	AI
Theoretical computer science	AI
Theory of computation	AI
Thompson sampling	AI
Time complexity	AI
Transhumanism	AI
Transition system	AI
Tree traversal	AI
True quantified Boolean formula	AI
Turing test	AI
Type system	AI
Unsupervised learning	AI
Vision processing unit	AI
Watson	AI
Weak AI	AI
World Wide Web Consortium	AI
absolute performance guarantee	DS_ALGORITHM
abstract data type	DS_ALGORITHM
tree	DS_ALGORITHM
accepting state	DS_ALGORITHM
Ackermann's function	DS_ALGORITHM
active data structure	DS_ALGORITHM
acyclic directed graph	DS_ALGORITHM
adaptive heap sort	DS_ALGORITHM
adaptive Huffman coding	DS_ALGORITHM
adaptive k-d tree	DS_ALGORITHM
adaptive sort	DS_ALGORITHM
address-calculation sort	DS_ALGORITHM
adjacency-list representation	DS_ALGORITHM
adjacency-matrix representation	DS_ALGORITHM
adversary	DS_ALGORITHM
algorithm	DS_ALGORITHM
algorithm BSTW	DS_ALGORITHM
algorithm FGK	DS_ALGORITHM
algorithmic efficiency	DS_ALGORITHM
algorithmically solvable	DS_ALGORITHM
algorithm V	DS_ALGORITHM
all pairs shortest path	DS_ALGORITHM
alphabet	DS_ALGORITHM
Alpha Skip Search algorithm	DS_ALGORITHM
alternating path	DS_ALGORITHM
alternating Turing machine	DS_ALGORITHM
alternation	DS_ALGORITHM
American flag sort	DS_ALGORITHM
amortized cost	DS_ALGORITHM
ancestor	DS_ALGORITHM
and	DS_ALGORITHM
ANSI	DS_ALGORITHM
antichain	DS_ALGORITHM
antisymmetric relation	DS_ALGORITHM
AP	DS_ALGORITHM
Apostolico–Crochemore	DS_ALGORITHM
Apostolico–Giancarlo algorithm	DS_ALGORITHM
approximate string matching	DS_ALGORITHM
approximation algorithm	DS_ALGORITHM
arborescence	DS_ALGORITHM
arithmetic coding	DS_ALGORITHM
array	DS_ALGORITHM
array index	DS_ALGORITHM
array merging	DS_ALGORITHM
array search	DS_ALGORITHM
articulation point	DS_ALGORITHM
A* search algorithm	DS_ALGORITHM
assignment problem	DS_ALGORITHM
association list	DS_ALGORITHM
associative	DS_ALGORITHM
associative array	DS_ALGORITHM
asymptotically tight bound	DS_ALGORITHM
asymptotic bound	DS_ALGORITHM
asymptotic lower bound	DS_ALGORITHM
asymptotic space complexity	DS_ALGORITHM
asymptotic time complexity	DS_ALGORITHM
asymptotic upper bound	DS_ALGORITHM
augmenting path	DS_ALGORITHM
automaton	DS_ALGORITHM
average case	DS_ALGORITHM
average-case cost	DS_ALGORITHM
AVL tree	DS_ALGORITHM
axiomatic semantics	DS_ALGORITHM
backtracking	DS_ALGORITHM
bag	DS_ALGORITHM
Baillie-PSW primality test	DS_ALGORITHM
balanced binary search tree	DS_ALGORITHM
balanced binary tree	DS_ALGORITHM
balanced k-way merge sort	DS_ALGORITHM
balanced merge sort	DS_ALGORITHM
balanced multiway merge	DS_ALGORITHM
balanced multiway tree	DS_ALGORITHM
balanced quicksort	DS_ALGORITHM
balanced tree	DS_ALGORITHM
balanced two-way merge sort	DS_ALGORITHM
BANG file	DS_ALGORITHM
Batcher sort	DS_ALGORITHM
Baum Welch algorithm	DS_ALGORITHM
BB α tree	DS_ALGORITHM
BDD	DS_ALGORITHM
BD-tree	DS_ALGORITHM
Bellman–Ford algorithm	DS_ALGORITHM
Benford's law	DS_ALGORITHM
best case	DS_ALGORITHM
best-case cost	DS_ALGORITHM
best-first search	DS_ALGORITHM
biconnected component	DS_ALGORITHM
biconnected graph	DS_ALGORITHM
bidirectional bubble sort	DS_ALGORITHM
big-O notation	DS_ALGORITHM
binary function	DS_ALGORITHM
binary GCD algorithm	DS_ALGORITHM
binary heap	DS_ALGORITHM
binary insertion sort	DS_ALGORITHM
binary knapsack problem	DS_ALGORITHM
binary priority queue	DS_ALGORITHM
binary relation	DS_ALGORITHM
binary search	DS_ALGORITHM
binary search tree	DS_ALGORITHM
binary tree	DS_ALGORITHM
binary tree representation of trees	DS_ALGORITHM
bingo sort	DS_ALGORITHM
binomial heap	DS_ALGORITHM
binomial tree	DS_ALGORITHM
bin packing problem	DS_ALGORITHM
bin sort	DS_ALGORITHM
bintree	DS_ALGORITHM
bipartite graph	DS_ALGORITHM
bipartite matching	DS_ALGORITHM
bisector	DS_ALGORITHM
bitonic sort	DS_ALGORITHM
bit vector	DS_ALGORITHM
Bk tree	DS_ALGORITHM
block	DS_ALGORITHM
block addressing index	DS_ALGORITHM
blocking flow	DS_ALGORITHM
block search	DS_ALGORITHM
Bloom filter	DS_ALGORITHM
blossom	DS_ALGORITHM
bogosort	DS_ALGORITHM
boogol	DS_ALGORITHM
boolean	DS_ALGORITHM
boolean expression	DS_ALGORITHM
boolean function	DS_ALGORITHM
bottleneck traveling salesman	DS_ALGORITHM
bottom-up tree automaton	DS_ALGORITHM
boundary-based representation	DS_ALGORITHM
bounded error probability in polynomial time	DS_ALGORITHM
bounded queue	DS_ALGORITHM
bounded stack	DS_ALGORITHM
Bounding volume hierarchy, also referred to as bounding volume tree	DS_ALGORITHM
Boyer–Moore string search algorithm	DS_ALGORITHM
Boyer–Moore–Horspool algorithm	DS_ALGORITHM
bozo sort	DS_ALGORITHM
B+ tree	DS_ALGORITHM
BPP	DS_ALGORITHM
Bradford's law	DS_ALGORITHM
branch	DS_ALGORITHM
branch	DS_ALGORITHM
branch and bound	DS_ALGORITHM
breadth-first search	DS_ALGORITHM
Bresenham's algorithm	DS_ALGORITHM
brick sort	DS_ALGORITHM
bridge	DS_ALGORITHM
British Museum algorithm	DS_ALGORITHM
brute force attack	DS_ALGORITHM
brute force search	DS_ALGORITHM
brute force string search	DS_ALGORITHM
brute force string search with mismatches	DS_ALGORITHM
BSP-tree	DS_ALGORITHM
B*-tree	DS_ALGORITHM
B-tree	DS_ALGORITHM
bubble sort	DS_ALGORITHM
bucket	DS_ALGORITHM
bucket array	DS_ALGORITHM
bucketing method	DS_ALGORITHM
bucket sort	DS_ALGORITHM
bucket trie	DS_ALGORITHM
buddy system	DS_ALGORITHM
buddy tree	DS_ALGORITHM
build-heap	DS_ALGORITHM
Burrows–Wheeler transform	DS_ALGORITHM
busy beaver	DS_ALGORITHM
Byzantine generals	DS_ALGORITHM
D-adjacent	DS_ALGORITHM
DAG shortest paths	DS_ALGORITHM
Damerau–Levenshtein distance	DS_ALGORITHM
data structure	DS_ALGORITHM
decidable	DS_ALGORITHM
decidable language	DS_ALGORITHM
decimation	DS_ALGORITHM
decision problem	DS_ALGORITHM
decision tree	DS_ALGORITHM
decomposable searching problem	DS_ALGORITHM
degree	DS_ALGORITHM
dense graph	DS_ALGORITHM
depoissonization	DS_ALGORITHM
depth	DS_ALGORITHM
depth-first search	DS_ALGORITHM
deque	DS_ALGORITHM
derangement	DS_ALGORITHM
descendant	DS_ALGORITHM
deterministic	DS_ALGORITHM
deterministic algorithm	DS_ALGORITHM
deterministic finite automata string search	DS_ALGORITHM
deterministic finite automaton	DS_ALGORITHM
deterministic finite state machine	DS_ALGORITHM
deterministic finite tree automaton	DS_ALGORITHM
deterministic pushdown automaton	DS_ALGORITHM
deterministic tree automaton	DS_ALGORITHM
Deutsch–Jozsa algorithm	DS_ALGORITHM
DFS forest	DS_ALGORITHM
DFTA	DS_ALGORITHM
diagonalization argument	DS_ALGORITHM
diameter	DS_ALGORITHM
dichotomic search	DS_ALGORITHM
dictionary	DS_ALGORITHM
diet	DS_ALGORITHM
difference	DS_ALGORITHM
digital search tree	DS_ALGORITHM
digital tree	DS_ALGORITHM
digraph	DS_ALGORITHM
Dijkstra's algorithm	DS_ALGORITHM
diminishing increment sort	DS_ALGORITHM
dining philosophers	DS_ALGORITHM
direct chaining hashing	DS_ALGORITHM
directed acyclic graph	DS_ALGORITHM
directed acyclic word graph	DS_ALGORITHM
directed graph	DS_ALGORITHM
discrete interval encoding tree	DS_ALGORITHM
discrete p-center	DS_ALGORITHM
disjoint set	DS_ALGORITHM
disjunction	DS_ALGORITHM
distributed algorithm	DS_ALGORITHM
distributional complexity	DS_ALGORITHM
distribution sort	DS_ALGORITHM
divide and conquer algorithm	DS_ALGORITHM
divide and marriage before conquest	DS_ALGORITHM
division method	DS_ALGORITHM
Data domain	DS_ALGORITHM
don't care	DS_ALGORITHM
Doomsday rule	DS_ALGORITHM
double-direction bubble sort	DS_ALGORITHM
double-ended priority queue	DS_ALGORITHM
double hashing	DS_ALGORITHM
double left rotation	DS_ALGORITHM
Double Metaphone	DS_ALGORITHM
double right rotation	DS_ALGORITHM
doubly chained tree	DS_ALGORITHM
doubly ended queue	DS_ALGORITHM
doubly linked list	DS_ALGORITHM
Dragon curve	DS_ALGORITHM
dual graph	DS_ALGORITHM
dual linear program	DS_ALGORITHM
Dutch national flag	DS_ALGORITHM
dyadic tree	DS_ALGORITHM
dynamic array	DS_ALGORITHM
dynamic data structure	DS_ALGORITHM
dynamic hashing	DS_ALGORITHM
dynamic programming	DS_ALGORITHM
dynamization transformation	DS_ALGORITHM
edge	DS_ALGORITHM
edge coloring	DS_ALGORITHM
edge connectivity	DS_ALGORITHM
edge crossing	DS_ALGORITHM
edge-weighted graph	DS_ALGORITHM
edit distance	DS_ALGORITHM
edit operation	DS_ALGORITHM
edit script	DS_ALGORITHM
8 queens	DS_ALGORITHM
elastic-bucket trie	DS_ALGORITHM
element uniqueness	DS_ALGORITHM
end-of-string	DS_ALGORITHM
enfilade	DS_ALGORITHM
epidemic algorithm	DS_ALGORITHM
Euclidean algorithm	DS_ALGORITHM
Euclidean distance	DS_ALGORITHM
Euclidean Steiner tree	DS_ALGORITHM
Euclidean traveling salesman problem	DS_ALGORITHM
Euclid's algorithm	DS_ALGORITHM
Euler cycle	DS_ALGORITHM
Eulerian graph	DS_ALGORITHM
Eulerian path	DS_ALGORITHM
exact string matching	DS_ALGORITHM
EXCELL	DS_ALGORITHM
exchange sort	DS_ALGORITHM
exclusive or	DS_ALGORITHM
exclusive read, concurrent write	DS_ALGORITHM
exclusive read, exclusive write	DS_ALGORITHM
exhaustive search	DS_ALGORITHM
existential state	DS_ALGORITHM
expandable hashing	DS_ALGORITHM
expander graph	DS_ALGORITHM
exponential	DS_ALGORITHM
extended binary tree	DS_ALGORITHM
extended Euclidean algorithm	DS_ALGORITHM
extended k-d tree	DS_ALGORITHM
extendible hashing	DS_ALGORITHM
external index	DS_ALGORITHM
external memory algorithm	DS_ALGORITHM
external memory data structure	DS_ALGORITHM
external merge	DS_ALGORITHM
external merge sort	DS_ALGORITHM
external node	DS_ALGORITHM
external quicksort	DS_ALGORITHM
external radix sort	DS_ALGORITHM
external sort	DS_ALGORITHM
extrapolation search	DS_ALGORITHM
extremal	DS_ALGORITHM
extreme point	DS_ALGORITHM
facility location	DS_ALGORITHM
factor	DS_ALGORITHM
factorial	DS_ALGORITHM
fast fourier transform	DS_ALGORITHM
fathoming	DS_ALGORITHM
feasible region	DS_ALGORITHM
feasible solution	DS_ALGORITHM
feedback edge set	DS_ALGORITHM
feedback vertex set	DS_ALGORITHM
Ferguson–Forcade algorithm	DS_ALGORITHM
Fibonacci number	DS_ALGORITHM
Fibonacci search	DS_ALGORITHM
Fibonacci tree	DS_ALGORITHM
Fibonacci heap	DS_ALGORITHM
filial-heir chain	DS_ALGORITHM
Find	DS_ALGORITHM
find kth least element	DS_ALGORITHM
finitary tree	DS_ALGORITHM
finite Fourier transform	DS_ALGORITHM
finite state automaton	DS_ALGORITHM
finite state machine	DS_ALGORITHM
finite state machine minimization	DS_ALGORITHM
finite state transducer	DS_ALGORITHM
first child-next sibling binary tree	DS_ALGORITHM
first come, first served	DS_ALGORITHM
first-in, first-out	DS_ALGORITHM
fixed-grid method	DS_ALGORITHM
flash sort	DS_ALGORITHM
flow	DS_ALGORITHM
flow conservation	DS_ALGORITHM
flow function	DS_ALGORITHM
flow network	DS_ALGORITHM
Floyd–Warshall algorithm	DS_ALGORITHM
Ford–Bellman algorithm	DS_ALGORITHM
Ford–Fulkerson algorithm	DS_ALGORITHM
forest	DS_ALGORITHM
forest editing problem	DS_ALGORITHM
formal language	DS_ALGORITHM
formal methods	DS_ALGORITHM
formal verification	DS_ALGORITHM
forward index	DS_ALGORITHM
fractal	DS_ALGORITHM
fractional knapsack problem	DS_ALGORITHM
fractional solution	DS_ALGORITHM
free edge	DS_ALGORITHM
free list	DS_ALGORITHM
free tree	DS_ALGORITHM
free vertex	DS_ALGORITHM
frequency count heuristic	DS_ALGORITHM
full array	DS_ALGORITHM
full binary tree	DS_ALGORITHM
full inverted index	DS_ALGORITHM
fully dynamic graph problem	DS_ALGORITHM
fully persistent data structure	DS_ALGORITHM
fully polynomial approximation scheme	DS_ALGORITHM
function	DS_ALGORITHM
function	DS_ALGORITHM
functional data structure	DS_ALGORITHM
Galil–Giancarlo	DS_ALGORITHM
Galil–Seiferas	DS_ALGORITHM
gamma function	DS_ALGORITHM
GBD-tree	DS_ALGORITHM
geometric optimization problem	DS_ALGORITHM
global optimum	DS_ALGORITHM
gnome sort	DS_ALGORITHM
goobi	DS_ALGORITHM
graph	DS_ALGORITHM
graph coloring	DS_ALGORITHM
graph concentration	DS_ALGORITHM
graph drawing	DS_ALGORITHM
graph isomorphism	DS_ALGORITHM
graph partition	DS_ALGORITHM
Gray code	DS_ALGORITHM
greatest common divisor	DS_ALGORITHM
greedy algorithm	DS_ALGORITHM
greedy heuristic	DS_ALGORITHM
grid drawing	DS_ALGORITHM
grid file	DS_ALGORITHM
Grover's algorithm	DS_ALGORITHM
halting problem	DS_ALGORITHM
Hamiltonian cycle	DS_ALGORITHM
Hamiltonian path	DS_ALGORITHM
Hamming distance	DS_ALGORITHM
Harter–Highway dragon	DS_ALGORITHM
hash function	DS_ALGORITHM
hash heap	DS_ALGORITHM
hash table	DS_ALGORITHM
hash table delete	DS_ALGORITHM
Hausdorff distance	DS_ALGORITHM
hB-tree	DS_ALGORITHM
head	DS_ALGORITHM
heap	DS_ALGORITHM
heapify	DS_ALGORITHM
heap property	DS_ALGORITHM
heapsort	DS_ALGORITHM
heaviest common subsequence	DS_ALGORITHM
height	DS_ALGORITHM
height-balanced binary search tree	DS_ALGORITHM
height-balanced tree	DS_ALGORITHM
heuristic	DS_ALGORITHM
hidden Markov model	DS_ALGORITHM
highest common factor	DS_ALGORITHM
Hilbert curve	DS_ALGORITHM
histogram sort	DS_ALGORITHM
homeomorphic	DS_ALGORITHM
horizontal visibility map	DS_ALGORITHM
Huffman encoding	DS_ALGORITHM
Hungarian algorithm	DS_ALGORITHM
hybrid algorithm	DS_ALGORITHM
hyperedge	DS_ALGORITHM
hypergraph	DS_ALGORITHM
Identity function	DS_ALGORITHM
ideal merge	DS_ALGORITHM
implication	DS_ALGORITHM
implies	DS_ALGORITHM
in-branching	DS_ALGORITHM
inclusion–exclusion principle	DS_ALGORITHM
inclusive or	DS_ALGORITHM
incompressible string	DS_ALGORITHM
incremental algorithm	DS_ALGORITHM
in-degree	DS_ALGORITHM
independent set	DS_ALGORITHM
index file	DS_ALGORITHM
information theoretic bound	DS_ALGORITHM
in-order traversal	DS_ALGORITHM
in-place sort	DS_ALGORITHM
insertion sort	DS_ALGORITHM
instantaneous description	DS_ALGORITHM
integer linear program	DS_ALGORITHM
integer multi-commodity flow	DS_ALGORITHM
integer polyhedron	DS_ALGORITHM
interactive proof system	DS_ALGORITHM
Interface	DS_ALGORITHM
interior-based representation	DS_ALGORITHM
internal node	DS_ALGORITHM
internal sort	DS_ALGORITHM
interpolation search	DS_ALGORITHM
interpolation-sequential search	DS_ALGORITHM
interpolation sort	DS_ALGORITHM
intersection	DS_ALGORITHM
interval tree	DS_ALGORITHM
intractable	DS_ALGORITHM
introsort	DS_ALGORITHM
introspective sort	DS_ALGORITHM
inverse Ackermann function	DS_ALGORITHM
inverted file index	DS_ALGORITHM
inverted index	DS_ALGORITHM
irreflexive	DS_ALGORITHM
isomorphic	DS_ALGORITHM
iteration	DS_ALGORITHM
Jaro–Winkler distance	DS_ALGORITHM
Johnson's algorithm	DS_ALGORITHM
Johnson–Trotter algorithm	DS_ALGORITHM
J sort	DS_ALGORITHM
JSort	DS_ALGORITHM
jump list	DS_ALGORITHM
jump search	DS_ALGORITHM
Karmarkar's algorithm	DS_ALGORITHM
Karnaugh map	DS_ALGORITHM
Karp–Rabin string search algorithm	DS_ALGORITHM
Karp reduction	DS_ALGORITHM
k-ary heap	DS_ALGORITHM
k-ary Huffman encoding	DS_ALGORITHM
k-ary tree	DS_ALGORITHM
k-clustering	DS_ALGORITHM
k-coloring	DS_ALGORITHM
k-connected graph	DS_ALGORITHM
k-d-B-tree	DS_ALGORITHM
k-dimensional	DS_ALGORITHM
K-dominant match	DS_ALGORITHM
k-d tree	DS_ALGORITHM
key	DS_ALGORITHM
KMP	DS_ALGORITHM
KmpSkip Search	DS_ALGORITHM
knapsack problem	DS_ALGORITHM
knight's tour	DS_ALGORITHM
Knuth–Morris–Pratt algorithm	DS_ALGORITHM
Königsberg bridges problem	DS_ALGORITHM
Kolmogorov complexity	DS_ALGORITHM
Kraft's inequality	DS_ALGORITHM
Kripke structure	DS_ALGORITHM
Kruskal's algorithm	DS_ALGORITHM
kth order Fibonacci numbers	DS_ALGORITHM
kth shortest path	DS_ALGORITHM
kth smallest element	DS_ALGORITHM
KV diagram	DS_ALGORITHM
k-way merge	DS_ALGORITHM
k-way merge sort	DS_ALGORITHM
k-way tree	DS_ALGORITHM
labeled graph	DS_ALGORITHM
language	DS_ALGORITHM
last-in, first-out	DS_ALGORITHM
Las Vegas algorithm	DS_ALGORITHM
lattice	DS_ALGORITHM
layered graph	DS_ALGORITHM
LCS	DS_ALGORITHM
leaf	DS_ALGORITHM
least common multiple	DS_ALGORITHM
leftist tree	DS_ALGORITHM
left rotation	DS_ALGORITHM
Lempel–Ziv–Welch	DS_ALGORITHM
level-order traversal	DS_ALGORITHM
Levenshtein distance	DS_ALGORITHM
lexicographical order	DS_ALGORITHM
linear	DS_ALGORITHM
linear congruential generator	DS_ALGORITHM
linear hash	DS_ALGORITHM
linear insertion sort	DS_ALGORITHM
linear order	DS_ALGORITHM
linear probing	DS_ALGORITHM
linear probing sort	DS_ALGORITHM
linear product	DS_ALGORITHM
linear program	DS_ALGORITHM
linear quadtree	DS_ALGORITHM
linear search	DS_ALGORITHM
link	DS_ALGORITHM
linked list	DS_ALGORITHM
list	DS_ALGORITHM
list contraction	DS_ALGORITHM
little-o notation	DS_ALGORITHM
Lm distance	DS_ALGORITHM
load factor	DS_ALGORITHM
local alignment	DS_ALGORITHM
local optimum	DS_ALGORITHM
logarithm, logarithmic scale	DS_ALGORITHM
longest common subsequence	DS_ALGORITHM
longest common substring	DS_ALGORITHM
Lotka's law	DS_ALGORITHM
lower bound	DS_ALGORITHM
lower triangular matrix	DS_ALGORITHM
lowest common ancestor	DS_ALGORITHM
l-reduction	DS_ALGORITHM
Malhotra–Kumar–Maheshwari blocking flow	DS_ALGORITHM
Manhattan distance	DS_ALGORITHM
many-one reduction	DS_ALGORITHM
Markov chain	DS_ALGORITHM
marriage problem	DS_ALGORITHM
Master theorem	DS_ALGORITHM
matched edge	DS_ALGORITHM
matched vertex	DS_ALGORITHM
matching	DS_ALGORITHM
matrix	DS_ALGORITHM
matrix-chain multiplication problem	DS_ALGORITHM
max-heap property	DS_ALGORITHM
maximal independent set	DS_ALGORITHM
maximally connected component	DS_ALGORITHM
Maximal Shift	DS_ALGORITHM
maximum bipartite matching	DS_ALGORITHM
maximum-flow problem	DS_ALGORITHM
MAX-SNP	DS_ALGORITHM
Mealy machine	DS_ALGORITHM
mean	DS_ALGORITHM
median	DS_ALGORITHM
meld	DS_ALGORITHM
memoization	DS_ALGORITHM
merge algorithm	DS_ALGORITHM
merge sort	DS_ALGORITHM
meromorphic function	DS_ALGORITHM
metaheuristic	DS_ALGORITHM
metaphone	DS_ALGORITHM
midrange	DS_ALGORITHM
Miller–Rabin primality test	DS_ALGORITHM
min-heap property	DS_ALGORITHM
minimal perfect hashing	DS_ALGORITHM
minimum bounding box	DS_ALGORITHM
minimum cut	DS_ALGORITHM
minimum path cover	DS_ALGORITHM
minimum spanning tree	DS_ALGORITHM
minimum vertex cut	DS_ALGORITHM
mixed integer linear program	DS_ALGORITHM
mode	DS_ALGORITHM
model checking	DS_ALGORITHM
model of computation	DS_ALGORITHM
moderately exponential	DS_ALGORITHM
MODIFIND	DS_ALGORITHM
monotone priority queue	DS_ALGORITHM
monotonically decreasing	DS_ALGORITHM
monotonically increasing	DS_ALGORITHM
Monte Carlo algorithm	DS_ALGORITHM
Moore machine	DS_ALGORITHM
Morris-Pratt	DS_ALGORITHM
move	DS_ALGORITHM
move-to-front heuristic	DS_ALGORITHM
move-to-root heuristic	DS_ALGORITHM
multi-commodity flow	DS_ALGORITHM
multigraph	DS_ALGORITHM
multilayer grid file	DS_ALGORITHM
multiplication method	DS_ALGORITHM
multiprefix	DS_ALGORITHM
multiprocessor model	DS_ALGORITHM
multiset	DS_ALGORITHM
multi suffix tree	DS_ALGORITHM
multiway decision	DS_ALGORITHM
multiway merge	DS_ALGORITHM
multiway search tree	DS_ALGORITHM
multiway tree	DS_ALGORITHM
Munkres' assignment algorithm	DS_ALGORITHM
naive string search	DS_ALGORITHM
nand	DS_ALGORITHM
n-ary function	DS_ALGORITHM
NC	DS_ALGORITHM
NC many-one reducibility	DS_ALGORITHM
nearest neighbor search	DS_ALGORITHM
negation	DS_ALGORITHM
network flow	DS_ALGORITHM
network flow problem	DS_ALGORITHM
next state	DS_ALGORITHM
NIST	DS_ALGORITHM
node	DS_ALGORITHM
nonbalanced merge	DS_ALGORITHM
nonbalanced merge sort	DS_ALGORITHM
nondeterministic	DS_ALGORITHM
nondeterministic algorithm	DS_ALGORITHM
nondeterministic finite automaton	DS_ALGORITHM
nondeterministic finite state machine	DS_ALGORITHM
nondeterministic finite tree automaton	DS_ALGORITHM
nondeterministic polynomial time	DS_ALGORITHM
nondeterministic tree automaton	DS_ALGORITHM
nondeterministic Turing machine	DS_ALGORITHM
nonterminal node	DS_ALGORITHM
nor	DS_ALGORITHM
not	DS_ALGORITHM
Not So Naive	DS_ALGORITHM
NP	DS_ALGORITHM
NP-complete	DS_ALGORITHM
NP-complete language	DS_ALGORITHM
NP-hard	DS_ALGORITHM
n queens	DS_ALGORITHM
nullary function	DS_ALGORITHM
null tree	DS_ALGORITHM
NYSIIS	DS_ALGORITHM
objective function	DS_ALGORITHM
occurrence	DS_ALGORITHM
octree	DS_ALGORITHM
offline algorithm	DS_ALGORITHM
offset	DS_ALGORITHM
omega	DS_ALGORITHM
omicron	DS_ALGORITHM
one-based indexing	DS_ALGORITHM
one-dimensional	DS_ALGORITHM
online algorithm	DS_ALGORITHM
open addressing	DS_ALGORITHM
optimal	DS_ALGORITHM
optimal cost	DS_ALGORITHM
optimal hashing	DS_ALGORITHM
optimal merge	DS_ALGORITHM
optimal mismatch	DS_ALGORITHM
optimal polygon triangulation problem	DS_ALGORITHM
optimal polyphase merge	DS_ALGORITHM
optimal polyphase merge sort	DS_ALGORITHM
optimal solution	DS_ALGORITHM
optimal triangulation problem	DS_ALGORITHM
optimal value	DS_ALGORITHM
optimization problem	DS_ALGORITHM
or	DS_ALGORITHM
oracle set	DS_ALGORITHM
oracle tape	DS_ALGORITHM
oracle Turing machine	DS_ALGORITHM
Orders of approximation	DS_ALGORITHM
ordered array	DS_ALGORITHM
ordered binary decision diagram	DS_ALGORITHM
ordered linked list	DS_ALGORITHM
ordered tree	DS_ALGORITHM
order preserving hash	DS_ALGORITHM
order preserving minimal perfect hashing	DS_ALGORITHM
oriented acyclic graph	DS_ALGORITHM
oriented graph	DS_ALGORITHM
oriented tree	DS_ALGORITHM
orthogonal drawing	DS_ALGORITHM
orthogonal lists	DS_ALGORITHM
orthogonally convex rectilinear polygon	DS_ALGORITHM
oscillating merge sort	DS_ALGORITHM
out-branching	DS_ALGORITHM
out-degree	DS_ALGORITHM
overlapping subproblems	DS_ALGORITHM
packing	DS_ALGORITHM
padding argument	DS_ALGORITHM
pagoda	DS_ALGORITHM
pairing heap	DS_ALGORITHM
PAM	DS_ALGORITHM
parallel computation thesis	DS_ALGORITHM
parallel prefix computation	DS_ALGORITHM
Parallel Random Access Machine	DS_ALGORITHM
parametric searching	DS_ALGORITHM
parent	DS_ALGORITHM
partial function	DS_ALGORITHM
partially decidable problem	DS_ALGORITHM
partially dynamic graph problem	DS_ALGORITHM
partially ordered set	DS_ALGORITHM
partially persistent data structure	DS_ALGORITHM
partial order	DS_ALGORITHM
partial recursive function	DS_ALGORITHM
partition	DS_ALGORITHM
passive data structure	DS_ALGORITHM
patience sorting	DS_ALGORITHM
path	DS_ALGORITHM
path cover	DS_ALGORITHM
path system problem	DS_ALGORITHM
Patricia tree	DS_ALGORITHM
pattern	DS_ALGORITHM
pattern element	DS_ALGORITHM
P-complete	DS_ALGORITHM
PCP	DS_ALGORITHM
Peano curve	DS_ALGORITHM
Pearson's hash	DS_ALGORITHM
perfect binary tree	DS_ALGORITHM
perfect hashing	DS_ALGORITHM
perfect k-ary tree	DS_ALGORITHM
perfect matching	DS_ALGORITHM
perfect shuffle	DS_ALGORITHM
performance guarantee	DS_ALGORITHM
performance ratio	DS_ALGORITHM
permutation	DS_ALGORITHM
persistent data structure	DS_ALGORITHM
phonetic coding	DS_ALGORITHM
pile	DS_ALGORITHM
pipelined divide and conquer	DS_ALGORITHM
planar graph	DS_ALGORITHM
planarization	DS_ALGORITHM
planar straight-line graph	DS_ALGORITHM
PLOP-hashing	DS_ALGORITHM
point access method	DS_ALGORITHM
pointer jumping	DS_ALGORITHM
pointer machine	DS_ALGORITHM
poissonization	DS_ALGORITHM
polychotomy	DS_ALGORITHM
polyhedron	DS_ALGORITHM
polylogarithmic	DS_ALGORITHM
polynomial	DS_ALGORITHM
polynomial-time approximation scheme	DS_ALGORITHM
polynomial hierarchy	DS_ALGORITHM
polynomial time	DS_ALGORITHM
polynomial-time Church–Turing thesis	DS_ALGORITHM
polynomial-time reduction	DS_ALGORITHM
polyphase merge	DS_ALGORITHM
polyphase merge sort	DS_ALGORITHM
polytope	DS_ALGORITHM
poset	DS_ALGORITHM
postfix traversal	DS_ALGORITHM
Post machine	DS_ALGORITHM
postman's sort	DS_ALGORITHM
postorder traversal	DS_ALGORITHM
Post's correspondence problem	DS_ALGORITHM
potential function	DS_ALGORITHM
predicate	DS_ALGORITHM
prefix	DS_ALGORITHM
prefix code	DS_ALGORITHM
prefix computation	DS_ALGORITHM
prefix sum	DS_ALGORITHM
prefix traversal	DS_ALGORITHM
preorder traversal	DS_ALGORITHM
primary clustering	DS_ALGORITHM
primitive recursive	DS_ALGORITHM
Prim's algorithm	DS_ALGORITHM
principle of optimality	DS_ALGORITHM
priority queue	DS_ALGORITHM
prisoner's dilemma	DS_ALGORITHM
PRNG	DS_ALGORITHM
probabilistic algorithm	DS_ALGORITHM
probabilistically checkable proof	DS_ALGORITHM
probabilistic Turing machine	DS_ALGORITHM
probe sequence	DS_ALGORITHM
Procedure	DS_ALGORITHM
process algebra	DS_ALGORITHM
proper	DS_ALGORITHM
proper binary tree	DS_ALGORITHM
proper coloring	DS_ALGORITHM
proper subset	DS_ALGORITHM
property list	DS_ALGORITHM
prune and search	DS_ALGORITHM
pseudo-random number generator	DS_ALGORITHM
pth order Fibonacci numbers	DS_ALGORITHM
P-tree	DS_ALGORITHM
purely functional language	DS_ALGORITHM
pushdown automaton	DS_ALGORITHM
pushdown transducer	DS_ALGORITHM
p-way merge sort	DS_ALGORITHM
qm sort	DS_ALGORITHM
qsort	DS_ALGORITHM
quadratic probing	DS_ALGORITHM
quadtree	DS_ALGORITHM
quadtree complexity theorem	DS_ALGORITHM
quad trie	DS_ALGORITHM
quantum computation	DS_ALGORITHM
queue	DS_ALGORITHM
quicksort	DS_ALGORITHM
Rabin–Karp string search algorithm	DS_ALGORITHM
radix quicksort	DS_ALGORITHM
radix sort	DS_ALGORITHM
ragged matrix	DS_ALGORITHM
Raita algorithm	DS_ALGORITHM
random access machine	DS_ALGORITHM
random number generation	DS_ALGORITHM
randomization	DS_ALGORITHM
randomized algorithm	DS_ALGORITHM
randomized binary search tree	DS_ALGORITHM
randomized complexity	DS_ALGORITHM
randomized polynomial time	DS_ALGORITHM
randomized rounding	DS_ALGORITHM
randomized search tree	DS_ALGORITHM
Randomized-Select	DS_ALGORITHM
random number generator	DS_ALGORITHM
random sampling	DS_ALGORITHM
range	DS_ALGORITHM
range sort	DS_ALGORITHM
Rank	DS_ALGORITHM
Ratcliff/Obershelp pattern recognition	DS_ALGORITHM
reachable	DS_ALGORITHM
rebalance	DS_ALGORITHM
recognizer	DS_ALGORITHM
rectangular matrix	DS_ALGORITHM
rectilinear	DS_ALGORITHM
rectilinear Steiner tree	DS_ALGORITHM
recurrence equations	DS_ALGORITHM
recurrence relation	DS_ALGORITHM
recursion	DS_ALGORITHM
recursion termination	DS_ALGORITHM
recursion tree	DS_ALGORITHM
recursive	DS_ALGORITHM
recursive data structure	DS_ALGORITHM
recursive doubling	DS_ALGORITHM
recursive language	DS_ALGORITHM
recursively enumerable language	DS_ALGORITHM
recursively solvable	DS_ALGORITHM
red-black tree	DS_ALGORITHM
reduced basis	DS_ALGORITHM
reduced digraph	DS_ALGORITHM
reduced ordered binary decision diagram	DS_ALGORITHM
reduction	DS_ALGORITHM
reflexive relation	DS_ALGORITHM
regular decomposition	DS_ALGORITHM
rehashing	DS_ALGORITHM
relation	DS_ALGORITHM
relational structure	DS_ALGORITHM
relative performance guarantee	DS_ALGORITHM
relaxation	DS_ALGORITHM
relaxed balance	DS_ALGORITHM
rescalable	DS_ALGORITHM
restricted universe sort	DS_ALGORITHM
result cache	DS_ALGORITHM
Reverse Colussi	DS_ALGORITHM
Reverse Factor	DS_ALGORITHM
R-file	DS_ALGORITHM
Rice's method	DS_ALGORITHM
right rotation	DS_ALGORITHM
right-threaded tree	DS_ALGORITHM
root	DS_ALGORITHM
root balance	DS_ALGORITHM
rooted tree	DS_ALGORITHM
rotate left	DS_ALGORITHM
rotate right	DS_ALGORITHM
rotation	DS_ALGORITHM
rough graph	DS_ALGORITHM
RP	DS_ALGORITHM
R+-tree	DS_ALGORITHM
R*-tree	DS_ALGORITHM
R-tree	DS_ALGORITHM
run time	DS_ALGORITHM
saguaro stack	DS_ALGORITHM
saturated edge	DS_ALGORITHM
SBB tree	DS_ALGORITHM
scan	DS_ALGORITHM
scapegoat tree	DS_ALGORITHM
search algorithm	DS_ALGORITHM
search tree	DS_ALGORITHM
search tree property	DS_ALGORITHM
secant search	DS_ALGORITHM
secondary clustering	DS_ALGORITHM
memory segment	DS_ALGORITHM
Select algorithm	DS_ALGORITHM
select and partition	DS_ALGORITHM
selection problem	DS_ALGORITHM
selection sort	DS_ALGORITHM
select kth element	DS_ALGORITHM
select mode	DS_ALGORITHM
self-loop	DS_ALGORITHM
self-organizing heuristic	DS_ALGORITHM
self-organizing list	DS_ALGORITHM
self-organizing sequential search	DS_ALGORITHM
semidefinite programming	DS_ALGORITHM
separate chaining hashing	DS_ALGORITHM
separation theorem	DS_ALGORITHM
sequential search	DS_ALGORITHM
Set	DS_ALGORITHM
set cover	DS_ALGORITHM
set packing	DS_ALGORITHM
shadow heap	DS_ALGORITHM
shadow merge	DS_ALGORITHM
shadow merge insert	DS_ALGORITHM
shaker sort	DS_ALGORITHM
Shannon–Fano coding	DS_ALGORITHM
Shared memory	DS_ALGORITHM
Shell sort	DS_ALGORITHM
Shift-Or	DS_ALGORITHM
Shor's algorithm	DS_ALGORITHM
shortcutting	DS_ALGORITHM
shortest common supersequence	DS_ALGORITHM
shortest common superstring	DS_ALGORITHM
shortest path	DS_ALGORITHM
shortest spanning tree	DS_ALGORITHM
shuffle	DS_ALGORITHM
shuffle sort	DS_ALGORITHM
sibling	DS_ALGORITHM
Sierpiński curve	DS_ALGORITHM
Sierpinski triangle	DS_ALGORITHM
sieve of Eratosthenes	DS_ALGORITHM
sift up	DS_ALGORITHM
signature	DS_ALGORITHM
Simon's algorithm	DS_ALGORITHM
simple merge	DS_ALGORITHM
simple path	DS_ALGORITHM
simple uniform hashing	DS_ALGORITHM
simplex communication	DS_ALGORITHM
simulated annealing	DS_ALGORITHM
simulation theorem	DS_ALGORITHM
single-destination shortest-path problem	DS_ALGORITHM
single-pair shortest-path problem	DS_ALGORITHM
single program multiple data	DS_ALGORITHM
single-source shortest-path problem	DS_ALGORITHM
singly linked list	DS_ALGORITHM
singularity analysis	DS_ALGORITHM
sink	DS_ALGORITHM
sinking sort	DS_ALGORITHM
skd-tree	DS_ALGORITHM
skew symmetry	DS_ALGORITHM
skip list	DS_ALGORITHM
skip search	DS_ALGORITHM
slope selection	DS_ALGORITHM
Smith algorithm	DS_ALGORITHM
Smith–Waterman algorithm	DS_ALGORITHM
smoothsort	DS_ALGORITHM
solvable problem	DS_ALGORITHM
sort algorithm	DS_ALGORITHM
sorted array	DS_ALGORITHM
sorted list	DS_ALGORITHM
sort in place	DS_ALGORITHM
sort merge	DS_ALGORITHM
soundex	DS_ALGORITHM
space-constructible function	DS_ALGORITHM
spanning tree	DS_ALGORITHM
sparse graph	DS_ALGORITHM
sparse matrix	DS_ALGORITHM
sparsification	DS_ALGORITHM
sparsity	DS_ALGORITHM
spatial access method	DS_ALGORITHM
spectral test	DS_ALGORITHM
splay tree	DS_ALGORITHM
SPMD	DS_ALGORITHM
square matrix	DS_ALGORITHM
square root	DS_ALGORITHM
SST	DS_ALGORITHM
stable	DS_ALGORITHM
stack	DS_ALGORITHM
stack tree	DS_ALGORITHM
star-shaped polygon	DS_ALGORITHM
start state	DS_ALGORITHM
state	DS_ALGORITHM
state machine	DS_ALGORITHM
state transition	DS_ALGORITHM
static data structure	DS_ALGORITHM
static Huffman encoding	DS_ALGORITHM
s-t cut	DS_ALGORITHM
st-digraph	DS_ALGORITHM
Steiner minimum tree	DS_ALGORITHM
Steiner point	DS_ALGORITHM
Steiner ratio	DS_ALGORITHM
Steiner tree	DS_ALGORITHM
Steiner vertex	DS_ALGORITHM
Steinhaus–Johnson–Trotter algorithm	DS_ALGORITHM
Stirling's approximation	DS_ALGORITHM
Stirling's formula	DS_ALGORITHM
stooge sort	DS_ALGORITHM
straight-line drawing	DS_ALGORITHM
strand sort	DS_ALGORITHM
strictly decreasing	DS_ALGORITHM
strictly increasing	DS_ALGORITHM
strictly lower triangular matrix	DS_ALGORITHM
strictly upper triangular matrix	DS_ALGORITHM
string	DS_ALGORITHM
string editing problem	DS_ALGORITHM
string matching	DS_ALGORITHM
string matching on ordered alphabets	DS_ALGORITHM
string matching with errors	DS_ALGORITHM
string matching with mismatches	DS_ALGORITHM
string searching	DS_ALGORITHM
strip packing	DS_ALGORITHM
strongly connected component	DS_ALGORITHM
strongly connected graph	DS_ALGORITHM
strongly NP-hard	DS_ALGORITHM
subadditive ergodic theorem	DS_ALGORITHM
subgraph isomorphism	DS_ALGORITHM
sublinear time algorithm	DS_ALGORITHM
subsequence	DS_ALGORITHM
subset	DS_ALGORITHM
substring	DS_ALGORITHM
subtree	DS_ALGORITHM
suffix	DS_ALGORITHM
suffix array	DS_ALGORITHM
suffix automaton	DS_ALGORITHM
suffix tree	DS_ALGORITHM
superimposed code	DS_ALGORITHM
superset	DS_ALGORITHM
supersink	DS_ALGORITHM
supersource	DS_ALGORITHM
symmetric relation	DS_ALGORITHM
symmetrically linked list	DS_ALGORITHM
symmetric binary B-tree	DS_ALGORITHM
symmetric set difference	DS_ALGORITHM
symmetry breaking	DS_ALGORITHM
symmetric min max heap	DS_ALGORITHM
tail	DS_ALGORITHM
tail recursion	DS_ALGORITHM
target	DS_ALGORITHM
temporal logic	DS_ALGORITHM
terminal	DS_ALGORITHM
terminal node	DS_ALGORITHM
ternary search	DS_ALGORITHM
ternary search tree	DS_ALGORITHM
text searching	DS_ALGORITHM
theta	DS_ALGORITHM
threaded binary tree	DS_ALGORITHM
threaded tree	DS_ALGORITHM
three-dimensional	DS_ALGORITHM
three-way merge sort	DS_ALGORITHM
three-way radix quicksort	DS_ALGORITHM
time-constructible function	DS_ALGORITHM
time/space complexity	DS_ALGORITHM
top-down radix sort	DS_ALGORITHM
top-down tree automaton	DS_ALGORITHM
top-node	DS_ALGORITHM
topological order	DS_ALGORITHM
topological sort	DS_ALGORITHM
topology tree	DS_ALGORITHM
total function	DS_ALGORITHM
totally decidable language	DS_ALGORITHM
totally decidable problem	DS_ALGORITHM
totally undecidable problem	DS_ALGORITHM
total order	DS_ALGORITHM
tour	DS_ALGORITHM
tournament	DS_ALGORITHM
towers of Hanoi	DS_ALGORITHM
tractable problem	DS_ALGORITHM
transducer	DS_ALGORITHM
transition	DS_ALGORITHM
transition function	DS_ALGORITHM
transitive relation	DS_ALGORITHM
transitive closure	DS_ALGORITHM
transitive reduction	DS_ALGORITHM
transpose sequential search	DS_ALGORITHM
travelling salesman problem	DS_ALGORITHM
treap	DS_ALGORITHM
tree	DS_ALGORITHM
tree automaton	DS_ALGORITHM
tree contraction	DS_ALGORITHM
tree editing problem	DS_ALGORITHM
tree sort	DS_ALGORITHM
tree transducer	DS_ALGORITHM
tree traversal	DS_ALGORITHM
triangle inequality	DS_ALGORITHM
triconnected graph	DS_ALGORITHM
trie	DS_ALGORITHM
trinary function	DS_ALGORITHM
tripartition	DS_ALGORITHM
Turbo-BM	DS_ALGORITHM
Turbo Reverse Factor	DS_ALGORITHM
Turing machine	DS_ALGORITHM
Turing reduction	DS_ALGORITHM
Turing transducer	DS_ALGORITHM
twin grid file	DS_ALGORITHM
two-dimensional	DS_ALGORITHM
two-level grid file	DS_ALGORITHM
2-3-4 tree	DS_ALGORITHM
2-3 tree	DS_ALGORITHM
Two Way algorithm	DS_ALGORITHM
two-way linked list	DS_ALGORITHM
two-way merge sort	DS_ALGORITHM
unary function	DS_ALGORITHM
unbounded knapsack problem	DS_ALGORITHM
uncomputable function	DS_ALGORITHM
uncomputable problem	DS_ALGORITHM
undecidable language	DS_ALGORITHM
undecidable problem	DS_ALGORITHM
undirected graph	DS_ALGORITHM
uniform circuit complexity	DS_ALGORITHM
uniform circuit family	DS_ALGORITHM
uniform hashing	DS_ALGORITHM
uniform matrix	DS_ALGORITHM
union	DS_ALGORITHM
union of automata	DS_ALGORITHM
universal hashing	DS_ALGORITHM
universal state	DS_ALGORITHM
universal Turing machine	DS_ALGORITHM
universe	DS_ALGORITHM
unsolvable problem	DS_ALGORITHM
unsorted list	DS_ALGORITHM
upper triangular matrix	DS_ALGORITHM
van Emde Boas priority queue	DS_ALGORITHM
vehicle routing problem	DS_ALGORITHM
Veitch diagram	DS_ALGORITHM
Venn diagram	DS_ALGORITHM
vertex	DS_ALGORITHM
vertex coloring	DS_ALGORITHM
vertex connectivity	DS_ALGORITHM
vertex cover	DS_ALGORITHM
vertical visibility map	DS_ALGORITHM
virtual hashing	DS_ALGORITHM
visibility map	DS_ALGORITHM
visible	DS_ALGORITHM
Viterbi algorithm	DS_ALGORITHM
VP-tree	DS_ALGORITHM
VRP	DS_ALGORITHM
walk	DS_ALGORITHM
weak cluster	DS_ALGORITHM
weak-heap	DS_ALGORITHM
weak-heap sort	DS_ALGORITHM
weight-balanced tree	DS_ALGORITHM
weighted, directed graph	DS_ALGORITHM
weighted graph	DS_ALGORITHM
window	DS_ALGORITHM
witness	DS_ALGORITHM
work-depth model	DS_ALGORITHM
work-efficient	DS_ALGORITHM
work-preserving	DS_ALGORITHM
worst case	DS_ALGORITHM
worst-case cost	DS_ALGORITHM
worst-case minimum access	DS_ALGORITHM
xor	DS_ALGORITHM
Yule–Simon distribution	DS_ALGORITHM
Zeller's congruence	DS_ALGORITHM
0-ary function	DS_ALGORITHM
0-based indexing	DS_ALGORITHM
0/1 knapsack problem	DS_ALGORITHM
Zhu–Takaoka string matching algorithm	DS_ALGORITHM
Zipfian distribution	DS_ALGORITHM
Zipf's law	DS_ALGORITHM
Zipper	DS_ALGORITHM
ZPP	DS_ALGORITHM
Account	FINANCE
Accounting	FINANCE
Accrue	FINANCE
Accumulate	FINANCE
Acquisition	FINANCE
Activity	FINANCE
Adjustable	FINANCE
Adjustment	FINANCE
AMEX	FINANCE
Amortization	FINANCE
Annual	FINANCE
Annuity	FINANCE
Appraisal	FINANCE
Arbitrage	FINANCE
Arrangement	FINANCE
Arrears	FINANCE
Assets	FINANCE
Authentic	FINANCE
Authorization	FINANCE
Automated	FINANCE
Average	FINANCE
Averaging	FINANCE
Balance	FINANCE
Balloon	FINANCE
payment	FINANCE
Bank	FINANCE
Bankrupt	FINANCE
Barter	FINANCE
Bear	FINANCE
Beneficiary	FINANCE
Bid	FINANCE
Blue	FINANCE
chip	FINANCE
Bond	FINANCE
Bracket	FINANCE
Broker	FINANCE
Brokerage	FINANCE
Bull	FINANCE
Buying	FINANCE
Buyout	FINANCE
Calculation	FINANCE
Call	FINANCE
Capital	FINANCE
gain	FINANCE
Cartel	FINANCE
Cashier	FINANCE
Certificate	FINANCE
Certified	FINANCE
Chart	FINANCE
Churn	FINANCE
Circulation	FINANCE
Clearinghouse	FINANCE
Collateral	FINANCE
Collect	FINANCE
Commission	FINANCE
Commodity	FINANCE
Common	FINANCE
stock	FINANCE
Compensation	FINANCE
Competitor	FINANCE
Compound	FINANCE
Conglomerate	FINANCE
Consolidation	FINANCE
Consortium	FINANCE
Consumer	FINANCE
Convertible	FINANCE
Correction	FINANCE
Cost	FINANCE
Counter	FINANCE
Countersign	FINANCE
Credit	FINANCE
Currency	FINANCE
Custodian	FINANCE
Deal	FINANCE
Debenture	FINANCE
Debit	FINANCE
Debt	FINANCE
Deductible	FINANCE
Deduction	FINANCE
Default	FINANCE
Delinquency	FINANCE
Demand	FINANCE
Depository	FINANCE
Depreciation	FINANCE
Depression	FINANCE
Deregulation	FINANCE
Designation	FINANCE
Devaluation	FINANCE
Differential	FINANCE
Discount	FINANCE
Discretionary	FINANCE
account	FINANCE
Distribution	FINANCE
Diversify	FINANCE
Dividend	FINANCE
Dow	FINANCE
Jones	FINANCE
Average	FINANCE
Downturn	FINANCE
Draft	FINANCE
Driven	FINANCE
Dump	FINANCE
Earn	FINANCE
Economy	FINANCE
Electronic	FINANCE
Elimination	FINANCE
Embezzlement	FINANCE
Endorse	FINANCE
Enterprise	FINANCE
Entity	FINANCE
Equity	FINANCE
Escrow	FINANCE
ESOP	FINANCE
(Employees	FINANCE
Stock	FINANCE
Ownership	FINANCE
Plan)	FINANCE
Estimation	FINANCE
Evaluation	FINANCE
Exceed	FINANCE
Exchange	FINANCE
rate	FINANCE
Exorbitant	FINANCE
Expectation	FINANCE
Extortion	FINANCE
Failure	FINANCE
Falling	FINANCE
price	FINANCE
Federal	FINANCE
Fees	FINANCE
Fiduciary	FINANCE
Finance	FINANCE
Fiscal	FINANCE
Fixed	FINANCE
Float	FINANCE
Foreclosure	FINANCE
Forfeiture	FINANCE
Frugality	FINANCE
Fulfillment	FINANCE
Fund	FINANCE
Funds	FINANCE
Futures	FINANCE
Gain	FINANCE
GDP	FINANCE
Gold	FINANCE
Government	FINANCE
Growth	FINANCE
Guarantee	FINANCE
Guaranty	FINANCE
High-interest	FINANCE
Hiring	FINANCE
Identification	FINANCE
Illegal	FINANCE
Imprint	FINANCE
Income	FINANCE
Index	FINANCE
Industrial	FINANCE
Inflated	FINANCE
price	FINANCE
Insider	FINANCE
information	FINANCE
Insolvent	FINANCE
Installment	FINANCE
Institution	FINANCE
Institutional	FINANCE
trading	FINANCE
Insufficient	FINANCE
Intangible	FINANCE
Interest	FINANCE
Interest-bearing	FINANCE
Intermediary	FINANCE
Intervention	FINANCE
Invalidate	FINANCE
Investment	FINANCE
IRA	FINANCE
Issue	FINANCE
Joint	FINANCE
account	FINANCE
Junk	FINANCE
Keogh	FINANCE
plan	FINANCE
Kiting	FINANCE
Laundering	FINANCE
LBO	FINANCE
(leveraged	FINANCE
buyout)	FINANCE
Lending	FINANCE
rate	FINANCE
Leverage	FINANCE
Liability	FINANCE
Lien	FINANCE
Liquidity	FINANCE
Long-term	FINANCE
Low	FINANCE
risk	FINANCE
Lucrative	FINANCE
Maintain	FINANCE
Margin	FINANCE
Market	FINANCE
Maturity	FINANCE
Member	FINANCE
Mercantile	FINANCE
Merger	FINANCE
Money	FINANCE
Monopoly	FINANCE
Municipals	FINANCE
Mutual	FINANCE
funds	FINANCE
Negotiable	FINANCE
Non-speculative	FINANCE
Note	FINANCE
NYSE	FINANCE
Obligation	FINANCE
Odd	FINANCE
lot	FINANCE
Operation	FINANCE
Option	FINANCE
OTC	FINANCE
(over	FINANCE
the	FINANCE
counter)	FINANCE
Overcompensate	FINANCE
Oversight	FINANCE
Ownership	FINANCE
Par	FINANCE
value	FINANCE
Payment	FINANCE
Peaks	FINANCE
Percent	FINANCE
Planning	FINANCE
Pledge	FINANCE
Points	FINANCE
Portfolio	FINANCE
Practice	FINANCE
Predetermine	FINANCE
Preferred	FINANCE
stock	FINANCE
Premium	FINANCE
Prepayment	FINANCE
penalty	FINANCE
Principal	FINANCE
Product	FINANCE
Profit	FINANCE
Progressive	FINANCE
Promissory	FINANCE
note	FINANCE
Public	FINANCE
Quality	FINANCE
Qualm	FINANCE
Quantity	FINANCE
Questionable	FINANCE
Quick	FINANCE
Quittance	FINANCE
Quote	FINANCE
Raid	FINANCE
Rally	FINANCE
Ramification	FINANCE
Rate	FINANCE
Ratio	FINANCE
Recession	FINANCE
Record	FINANCE
Recoup	FINANCE
Recourse	FINANCE
Redemption	FINANCE
Reduction	FINANCE
Regulation	FINANCE
Reimburse	FINANCE
Reliability	FINANCE
Reserves	FINANCE
Retirement	FINANCE
Risk	FINANCE
Rumors	FINANCE
Sale	FINANCE
Savings	FINANCE
Securities	FINANCE
Select	FINANCE
Sell-off	FINANCE
Selling	FINANCE
Shares	FINANCE
Short	FINANCE
term	FINANCE
Shylock	FINANCE
Slump	FINANCE
Solvency	FINANCE
Speculate	FINANCE
Speculative	FINANCE
Split	FINANCE
Stagflation	FINANCE
Stock	FINANCE
split	FINANCE
Stocks	FINANCE
Subscription	FINANCE
Summary	FINANCE
Supply	FINANCE
and	FINANCE
demand	FINANCE
Surety	FINANCE
Surplus	FINANCE
Survivorship	FINANCE
Swap	FINANCE
Takeover	FINANCE
Tax	FINANCE
shelter	FINANCE
Tax	FINANCE
year	FINANCE
Tax-exempt	FINANCE
Taxes	FINANCE
Technical	FINANCE
Tender	FINANCE
Thrifts	FINANCE
Ticker	FINANCE
tape	FINANCE
Trade	FINANCE
Transaction	FINANCE
Transfer	FINANCE
Transferable	FINANCE
Treasury	FINANCE
bill	FINANCE
Trends	FINANCE
Uncollected	FINANCE
Underwriter	FINANCE
Unit	FINANCE
Unofficial	FINANCE
Unregulated	FINANCE
Unsecured	FINANCE
Untaxed	FINANCE
Usury	FINANCE
Utilities	FINANCE
Valuable	FINANCE
Value	FINANCE
Variable	FINANCE
Vault	FINANCE
Venture	FINANCE
Void	FINANCE
Voucher	FINANCE
Wage	FINANCE
Warrant	FINANCE
Wide-ranging	FINANCE
Withdrawal	FINANCE
Yield	FINANCE
Zero-coupon	FINANCE
bond	FINANCE
a	OTHER
am	OTHER
aboard	OTHER
about	OTHER
above	OTHER
absent	OTHER
advanced	OTHER
according	OTHER
across	OTHER
act	OTHER
active	OTHER
after	OTHER
against	OTHER
age	OTHER
all	OTHER
along	OTHER
alongside	OTHER
amid	OTHER
amidst	OTHER
among	OTHER
and	OTHER
anti	OTHER
any	OTHER
are	OTHER
areas	OTHER
around	OTHER
as	OTHER
at	OTHER
atop	OTHER
auto	OTHER
availability	OTHER
bar	OTHER
barring	OTHER
base	OTHER
before	OTHER
behind	OTHER
below	OTHER
beneath	OTHER
beside	OTHER
besides	OTHER
between	OTHER
beyond	OTHER
big	OTHER
both	OTHER
broad	OTHER
business	OTHER
but	OTHER
by	OTHER
capabilities	OTHER
circa	OTHER
clean	OTHER
close	OTHER
commercial	OTHER
complex	OTHER
concerning	OTHER
considering	OTHER
contain	OTHER
containing	OTHER
contribute	OTHER
contributes	OTHER
counting	OTHER
critical	OTHER
customer	OTHER
deliver	OTHER
despite	OTHER
down	OTHER
drive	OTHER
during	OTHER
ensure	OTHER
enterprise	OTHER
environment	OTHER
environmentol	OTHER
environments	OTHER
etc	OTHER
excellent	OTHER
except	OTHER
excepting	OTHER
excluding	OTHER
exp	OTHER
experience	OTHER
expertise	OTHER
financial	OTHER
field	OTHER
file	OTHER
files	OTHER
find	OTHER
following	OTHER
for	OTHER
from	OTHER
full	OTHER
gain	OTHER
general	OTHER
given	OTHER
global	OTHER
gone	OTHER
good	OTHER
great	OTHER
greater	OTHER
greatest	OTHER
group	OTHER
guidance	OTHER
has	OTHER
he	OTHER
high	OTHER
home	OTHER
hot	OTHER
how	OTHER
however	OTHER
idea	OTHER
ideas	OTHER
ideal	OTHER
identify	OTHER
identity	OTHER
implement	OTHER
implications	OTHER
important	OTHER
improve	OTHER
in	OTHER
in front of	OTHER
include	OTHER
including	OTHER
informatica	OTHER
information	OTHER
ing	OTHER
inside	OTHER
insight	OTHER
instead of	OTHER
integrate	OTHER
into	OTHER
is	OTHER
it	OTHER
key	OTHER
language	OTHER
languages	OTHER
large	OTHER
larger	OTHER
largest	OTHER
lead	OTHER
leader	OTHER
leaders	OTHER
leading	OTHER
learning	OTHER
less	OTHER
like	OTHER
local	OTHER
made	OTHER
make	OTHER
manage	OTHER
management	OTHER
may	OTHER
medicines	OTHER
mid	OTHER
migrations	OTHER
minus	OTHER
most	OTHER
multiple	OTHER
national	OTHER
near	OTHER
new	OTHER
next	OTHER
number	OTHER
of	OTHER
off	OTHER
on	OTHER
on top of	OTHER
onto	OTHER
open	OTHER
opposite	OTHER
out	OTHER
out of	OTHER
outside	OTHER
over	OTHER
part	OTHER
past	OTHER
pending	OTHER
people	OTHER
per	OTHER
plan	OTHER
plus	OTHER
portfolio	OTHER
post	OTHER
power	OTHER
practical	OTHER
pre	OTHER
primary	OTHER
pro	OTHER
public	OTHER
push	OTHER
real	OTHER
refine	OTHER
regarding	OTHER
regardless of	OTHER
round	OTHER
run	OTHER
save	OTHER
saving	OTHER
secondary	OTHER
senior	OTHER
she	OTHER
since	OTHER
skill	OTHER
skills	OTHER
society	OTHER
solution	OTHER
solutions	OTHER
source	OTHER
status	OTHER
support	OTHER
table	OTHER
tables	OTHER
team	OTHER
teams	OTHER
than	OTHER
that	OTHER
the	OTHER
them	OTHER
there	OTHER
they	OTHER
three	OTHER
through	OTHER
throughout	OTHER
till	OTHER
time	OTHER
times	OTHER
title	OTHER
to	OTHER
toward	OTHER
towards	OTHER
trouble	OTHER
trusted	OTHER
tune	OTHER
type	OTHER
under	OTHER
underneath	OTHER
undo	OTHER
uniquely	OTHER
unlike	OTHER
until	OTHER
up	OTHER
upon	OTHER
use	OTHER
user	OTHER
uses	OTHER
using	OTHER
versus	OTHER
via	OTHER
was	OTHER
water	OTHER
want	OTHER
wanted	OTHER
which	OTHER
who	OTHER
will	OTHER
with	OTHER
within	OTHER
without	OTHER
work	OTHER
working	OTHER
works	OTHER
worth	OTHER
would	OTHER
you	OTHER